habiller: vestir
emmener: llevar
mesurer: medir
partager: compartir
déranger: molestar
sauter: saltar
parier: apostar
arroser: regar
deviner: adivinar
apporter: traer
monter: subir (tiene muchos usos igual que el subir del español)
tromper: equivocar
payer: pagar
souhaiter: desear
empoisonner: envenenar
démissionner: renunciar
tuer: matar
risquer: correr riesgo
exploser: explotar
coucher: acostar
retirer: retirar - quitar
croiser: cruzar
baisser: agachar (informal)
partager: compartir
prêter: prestar
emprunter: pedir prestado
traiter
répéter: repetir
consoler: consolar
amuser: entretener - divertir
ajouter: agregar - añadir
tomber: caer
déguiser: disfrazar
resserrer: apretar
cacher: esconder
claquer: cerrar la puerta con un portazo
fumer: fumar
allumer: encender
ressembler: parecerse (ejemplo: quelque choe qui ressemble)
déménager: mudarse - reubicarse
traverser: atravesar
remporter: ganar (obtener algo como "earn" en inglés)
refléter: reflexionar
veiller: vigilar (en el sentido de cuidar)
attirer: atraer
signifier: significar
enquêter: investigar
avouer: confesar
soucier: preocuparse

flâner: pasear
se promener: pasear
balader (coloquial): pasear