toi d'abord: tú primero/a
à peine : a penas
tout de suite: en seguida
bonne chance: buena suerte
bien sûr: por supuesto
de toute façon: de todos modos
c'est dommage: es una pena
pour l'instant: por ahora
a nous deux: entre nosotros dos
aussi __ que: tan __ que (as __ as)
dès que possible: lo antes posible
je compte sur toi: Cuento contigo
Je suis de retour: Estoy de vuelta
il faut que...: es necesario que...
remonte: volver (como "tus puntos vuelven a subir")
l'un des plus anciens: uno de los mas viejos
faire attention: tener cuidado - prestar atención
les unes que les autres: entre sí - unos más que otros
de ce fait: de hecho
D'après (de après): de acuerdo a
il y a X: hace X tiempo
c'est a peine...: es apenas...
par dessus: por encima de

être pressé(e): Tener prisa / Estar apurado
être à l'heure: llegar a la hora / llegar a tiempo
avoir chaud: tener calor
avoir très chaud: tener mucho calor
avoir froid: tener frío
avoir faim: tener hambre
avoir soif: tener frío
avoir peur: tener miedo
avoir sommeil: tener sueño
avoir raison: tener razón
avoir tort: no tener razón
avoir envie: tener ganas
avoir besoin de: necesitar
avoir hâte: no poder esperar que
avoir l'habiture: estar acostumbrado
avoir de la chance: tener suerte

se rendre compte: darse cuenta
pas si vite: no tan rápido