tendance: tendencia
pote: camarada
rhume: resfrío
boîte: caja
taille (f): talla, tamaño
mouchoir: pañuelo
glace(s): helado(s)
ferré: relleno/a
gauche: izquierda
droite: derecha
après-midi: tarde (después de las 12 del medio día). "après" es  su contracción informal
bêtise: tontería
engrais: fertilizante
odeur: olor
rendez-vous: cita (cualquier tipo de cita. Se refiere a una reunión de dos o más personas)
piège: trampa
blague (f): broma, chiste
âge: edad.
moto: moto
balai (m): escoba
fumée (m): humo
boulot: trabajo
emploi: empleo
colis: paquete
patron: jefe
boss: jefe (informal)
goût: sabor
économie: ahorro
escalier (m): escalera
côté: lado
arme (f): arma
ferme: granja
laine: lana
malade: paciente (de médico)
reflet: reflejo (imagen)
réflexe: reflejo (acción involuntaria)
température: temparatura
piqûre: inyección - picadura
aéroport: aeropuerto
étagère (f): estante
cauchemar (m): pesadilla
roi: rey
reine: reina
vis (f): tornillo